%%%%%%%%%%%%%%%%%%%%%%
%G%%        % %      %
%    %%%%%%O% %%%%%% %
%%%%%%     P        G%
%    % %%%%%% %% %%%%%
% %%%% %             %
%        %%% %%%   % %
%%%% O%%%%    %%  %% %
%                    %
%G     %       %    G%
%%%%%%%%%%%%%%%%%%%%%%