%%%%%%%%%%%%%%%%%%%
%G        G       %
% % % %%%%%% %W%% %
% % % %    % %  % %
% %%% %  %%% %  % %
%W      S    %  %G%
%%%%%%%%%%%%%%%%%%%
