%%%%%%%%%%%%%%%%%%%%%%
%G%%        % %      %
%    %%%%%%W% %%%%%% %
%%%%%%     S        G%
%    % %%%%%% %% %%%%%
% %%%% %             %
%        %%% %%%   % %
%%%% W%%%%    %%  %% %
%                    %
%G     %       %    W%
%%%%%%%%%%%%%%%%%%%%%%