%%%%%%%%%%%%%%%%%%%%
%G            G%   %
% %% %% %% %%W%% % %
%        S       % %
%%%%%%%%%%%%%%%%%% %
%      G           %
%%%%%%%%%%%%%%%%%%%%