%%%%%%%%%%%%%%%%%%%
%G        G       %
% % % %%%%%% %O%% %
% % % %    % %  % %
% %%% %  %%% %  % %
%O      P    %  %G%
%%%%%%%%%%%%%%%%%%%
